﻿i havent been sleeping well lately / for the past week - nespal som posledny vikend dobre
i may be sensitive - mozno som citlivy
caffeine - kofein
so i started joining them - tak som zacal chodit s nimi
revitalizing - vzpruzujuce
go for coffee break - dat si kaffee pauzu
herbal tee - bylinkovy caj
sleeping disorders - poruchy spanku
i am exhausted - som vycerpany
school boy - ziacik
i havent seen pistoktas for the last 5 years - nevidel som piskoty poslednych 5 rokov
as the first thing in the morning - ako prvu vec rano
brunch - kombinacia ranajok a obeda
aboreigner - cudzinec
swiss saga - svajciarska saga
it starts to dawn on me (that i was right with my decision) - zacina mi to dochadzat
scared - vystraseny
content - spokojny
handy - sikovne
practical - prakticke
fauvorite - oblubena
tiring - unavujuca
time consuming - casovo narocna
excelent, great - skvely
fine - qualitne
gross - nechutny
fair - ferovy
strict - prisny
punctual - dochvinly
helpfull - napomocny
straigtforward - priamociary
rude, cheeky - drzy
urban - mestska
you didnt missed too much - ovela si neprisiel
at the time when i played the last release of the game - vtedy ked som hral tuto verziu hry
i am growing up of this - vyrastam z toho 
promo campain - promo kampan
claim - tvrdenie
helicopter, chopper - vrtulnik
i was serious - myslel som to vazne
a lot of hussle, its not worth the hassle - vela opletacek
i am cooking with gas - vsetko je v pohode
graphics - grafika
previous, former - predosli
once i get rich - raz ked budem bohaty
the older i am the less time i spent - cim som starsi, tym menej casu
since ever i heart that - odkedy som to pocul
cheat on - podvazdat
they dont have true friends - nemas skutocnych priatelov
thats clear - to je jasne
i have been teaching english for over 15 year - ucim anglictinu 15 rokov
i have enough and i am thinking about the change - mam dost a myslim na zmenu
rewarding - uspokojujuce
relativelly - relativne 
get by - vyzit
take a loan - vziat si pozicku
pay card, cretidt card - kreditka
cash, atm maschine - bankomat
i need to withdraw some money - potrebujem si vybrat prachy
current account - bezny ucet
rip off - odrb cenovy
customer, client, guest - zakaznik
wealthy - majetny
price, prize (wimbledon) - cena, cena (vyhra)
payment - platba
budget - rozpocet
receipt - uctenka
i bought - kupil som
i sold - predal som
i came - prisiel som
i did - urobil som
i made - spravil som
i drank - vypil som
i ate the bread - zjedol som chleba
i fought with - bojoval som s
i flew - letel som
i went to - isiel som do
her grew - vyrastol
i had - mal som
i paid - zaplatil som
i read - cital som
i sent - poslal som
i sang - spieval som
i slept - spal som
i spoke - hovoril som
i spent there - stravil som tam
i began - zacal som
i swam - plaval som 
i understood - rozumel som
i woke up, i got up - prebudil som sa
i wore t-shirt - mal som na sebe tricko
i wrote - napisal som
hand inprints - odtlacky ruk
small coastal city on the cliff - male pobrezne mesto na hore
stinky rich people in the bay (port) - nechutne bohaty ludia v pristave
circuit - okruh
it made an impression on me - urobilo to na mna dojem
gudge - posudit
distinguish - rozlisit
work canteen - kantina v praci
furnish - zariadit
laught at it - smiat sa na tom
i was afraid of - bal som sa
emarassing - trapna
suspiscious - podozrivo
what is your take on - ako to vidis s ...
business related issues - biznis problemy
you are my brother, brother from another mother - si moj brat...
hangover - opica
the feeling is mutual - presne je to tak u mna
appointment at work - meeting v praci
do i look like a person who - vyzeram ako niekto kto
less - menej
at least - aspon
do you habe any books ? - mas nejake knihy ?
impact - dopad
influence - vplyv
the shit is gonna hit the fan - nedopadne to dobre
at the time - v tom case.
queue - rada
snake - had
sweets - sladkosti
if not today - ak nie dnes
now, right now - teraz, prave teraz
sometimes i go to work sooner - niekedy idem do roboty skorej
see you tomorrow - bis morgen
give my best regards to your wife - pozdravuj manzelku
could you do me a favour ? - mozes mi urobit laskavost?
be so kind and.. - but taky dobry a ..
i wish you good luck - zelam vela stastia
here you are - nech sa paci
as you wish - ako si zelas
i am in a hurry - ponahlam sa
where are you staying - kde si ubytovany
give a ride - zaviest
according to - podla 
wrack - srot
how comes ? - ako je to mozne?
as far as i know - pokial viem
surgery - operacia
i feel edgy - som napnuty
get damaged - poskodit
vanish (into thin aior)- vyparit sa
between - medzi
in the very end - uplne nakoniec
via phone - cez telefon
via email - cez email
please can you confirm this reservation by sending email to... - mozte potvrdit rezervaciu poslatim emailu
usefull - uzitocny
get rid of - zbavit sa
petrol station - benzinka
grind, grinder - mliet, mlyncek
she might by... - mozno ze ona je...
come over - zastavit sa...vorbei kommen
definitely, absolutely - auf jeden fall
what time, when - o kolkej, kedy
im not feeling guilty about that - ale nemrzi ma to, nemam vycitky svedomia
are you joining us tomorrow - bist du morgen dabei
i should be there by 11 - mal by som tam byt do 11
again - znovu, wieder
i will give you a call - zavolam ti
what is wrong with it ? - co sa ti na tom nepaci?
up to date - aktualne
urgent - surne
let me know - daj mi vediet
do you mind, if .. ? - nevadilo by ti, ak...
by the way - übrigens
adjust - anpassen
stay overnight - prenocovat
since - od
i need to see the doctor - musim k doktorovi
doctor - doktor
pain - bolest
flu, cold  - chripka, nadcha
ill, sick - chory
fever, high temperature - horucka
headache - bolest hlavy
cough - kasel
sneeze - kychat
high blood presure - vysoky tlak
mediaction - lieky
x-ray - rengen
wound - rana
i do it with intention - robim to so zamerom
even dough - napriek tomu, trotzdem
illnes, disease - krankheit
mandatory - povinny
200 euro per month - 200 euro za mesiac
especially - vor allem
farmacy - lekaren
not at all - vobec nie
happy - stastny
sad - smutny
scared - ustrachany
in love - zalubeny
annoying - otravny
pissed off - stinksauer
tired - unaveny
bored - znudeny
excited - nadrzany
confused - zmeteny
around 5 oclock - okolo 5tej
yuck.. - fuj..
i dreamt.. - snival som...
i forgot ... - zabudol som..
i felt... - citil som...
instead of - namiesto
allover - po celom povrchu
omit - vynechat
the are very alike / similar - su velmi podobny
im comparison to... - v porovnani
i will be on my mobile - som na telefone
fortunatelly, unfortunatelly - nastastie, nanestastie
so to say - sozusagen
break - prestavka
i am glad when the lesson is over - som stastny ked je hodina ukonce
i have no other choice but to go to school - nemam inu moznost ako ist do skoly
healty, unhealthy - zdravy, nezdravy
i await your reply - ich erwarte ihre antwort
witty - vtipný
how was your weekend? - aky si mal vikend?
get on with each other - vychadzat
have you been to aerobick yesterday - bola si vcera na aerobiku
for ages - ani nepamatujem
to be afraid of - mat strach z
definitely, of course - samozrejme
in time - nacas
it turned out.. - ukazalo sa...
easier - einfacher
interested in - zaujimam sa o
i tend to - mam tendenciu, priklanam sa
i cant get hold of him - nemozem ho zohnat
i am buying today - dnes pozyvam
sure - ja klar
is now a good time to talk? are you ok to talk? - mozete teraz hovorit?
you can bet your life on it - nato mozes vziat jed
could you pick me up at 12? - mozes ma vyzdvihnut o 12tej?
last night - vcera vecer
i will show you - ukazem ti to
do you know how... - vies ako?
check out, check it out - ocihat, ocihaj to
can you chase that up ? - mozes to vybavit
du you fancy ? - nemas chut na ?
no problem - nic sa nedeje
that makes two of us, me too - tak to sme dvaja, ja tiez
will do - mache ich
elsewhere - inde
suddenly, all of the sudden - zrazu
atm machine - bankomat
to the right, on the right - doprava, vpravo
all the time, still - stale, este stale
put away, put down - odlozit
illustrate - uvies priklad
for instance, for example - napriklad
see, visit - navstivit
above, underneath, over, below - nad, pod
especially, in particular - obzvlast
coskoro - shortly
simulataneously - paralelne
so far - doposial
tricky - heikel
when was the last time ... - kedy si naposledy...
very long time ago - velmi davno
donate blood - darovat krv
get along, gen on - rozumiet si
who from ? - od koho
i need to make up my mind - rozmyslim si to
make up - made up - vymysliet si
i look forward, i am looking forward to... - vzdy sa tesim..., tesim sa na tento vikend
I hope that everything will work - dufam ze to vsetko klapne
i am not used to live in a big city, i need to get used to life in a big city - nie som zvyknuty zit vo velkom meste, musim si zvyknut na zivot vo velkom meste
take advantage of - ausnutzen
hold on - warte ab
go with, to choose one thing rather than another - nieco si vybrat
take place - stattfinden
majority - mehrheit
embarrassing - peinlich
this is unfortunate - das ist unglücklich
even though - obwohl
capable of - fähig
in more depth - do hlbky
until now, so far - bis jetzt
comfortable - prijemny, pohodlny
according to - podla, gemäss
suddenly - plötzlich
study on my own - ucit sa sam
area - das bereich
interrupt me - unterbrechen
get rid of my old television - los werden
for sure - urcite
in detail - detailne
actually, in fact - eigentlich
heap of words - hromada slov
in common - gemeinsam
look up - vyhladat
look for - hladat
kind of, somehow - irgendwie
are you familiar with... - vyznas sa v...
i need to deal with... - musim vyriesit..
doesnt matter, never mind - egal!
no matter - unabhängig davon....
as easy as pie - lahke ako facka
suppose..what if... - co keby...
if i were you... - keby som bol ty..
are you good at bedmiton ? - si dobry v bedmintone?
count me in, count me out - rataj somnou, nerataj somnou
i am sick and tired of it - mam toho po krk
i am having trouble with.. - mam problem s...
could you give some pointers... - mohol by si mi dat nejake rady...
step by step, drip by drip - krok za krokom
what is your brother up to ? - jak sa dari tvojmu bratovi
we have to go out sometime - niekedy musime ist von
on the web - na nete
in the paper - v novinach
thats a pitty! - to je smola!
apart from... - okrem...odhliadnuc od...
result, outcome - vysledok
for breakfast, for lunch - na obed, na ranajky
spanish from spain speaks spanish - spanielka zo spanielska hovori spaniesky
at wedding - na svadbe
at tesco - v tescu
at night, at midnight - v noci, o polnoci
that is mind blowing - je to pozoruhodne
recently - prave
at least - najmenej
you can run into problems - dostat sa do problemov
also - also
reschedule, move, postpone - posunut, presunut
celebrate - oslavovat
get dressed - obliect sa
run, jog - behat
earn, make money - zarabat
to be on FB - by nat fb
dream - snivat
take a chance - vyuzit sancu
surt the Net - surfovat na nete
shave - holit
repeat - opakovat
dissapoint - sklamat
chat - kecat
get changed - prezliect sa
on vacation - na dovolenke
neglect - vernachlässigen
straight away, right away - okamzite
if she is out, she has her mobile phone - ked je prec, ma mobil
tonight - dnes vecer
first, first of all - najprv
at the age of 55 - ako 55 rocna
from monday to friday till friday - od pondelka do piatka do piatka
at work - v praci
in the picture - na obrazku
during the weekend, at the weekend, over the weekend - cez vikend
in the car, on the plane - v aute, v lietadle
in the morning, in thie afternoon, in thii evening - rano, na obed, vecer
i prefer a to b - uprednostnujem nieco pred niecim
negotiate - vyjednavat
relate - sich auf etwas beziehen
offer - ponukat
lose - verlieren
limit - begrenzen
involve - beteiligen
fasten - befestigen
express - äußern
on demand - na poziadanie
confirm - bestätigen
commit - zaviazat sa
accept - akzeptieren
account - buchen
achieve - erreichen
add - hinzufügen
admit - zugeben
affect - beeinflussen
agree - zustimmen
aim - zielen
allow - erlauben
answer - beantworten
appear - erscheinen
apply - anwenden
argue - argumentieren
arrange - arrangieren
arrive - ankommen
ask - fragen
attack - angreifen
avoid - vermeiden
base - basieren
be - sein
become - werden
begin - beginnen
believe - glauben
belong - gehören
break - brechen
build - bauen
burn - brennen
buy - kaufen
call - rufen
can - können
care - kümmern
carry - niest
catch - fangen
cause - verursachen
change - ändern
charge - aufladen
check - überprüfen
choose - wählen
claim - behaupten
clean - reinigen
clear - löschen
climb - klettern
close - schließen
collect - sammeln
come - kommen
compare - vergleichen
complain - beschweren
complete, finish - abschließen
connect - verbinden
consider - bedenken
consist - bestehen aus
contact - kontaktieren
contain - obsahovat
continue - fortsetzen
contribute - beitragen
control - kontrolovat
cook - kochen
copy - kopieren
correct - korrigieren
cost - kosten
could - könnte
count - zählen
cover - pokryvat
create - erzeugen
cross - überqueren
cry - weinen
cut - schneiden
damage - beschädigen
dance - tanzen
decide - entscheiden
deliver - dorucit
deny - ablehnen
depend - abhängen
describe - beschreiben
design - entwerfen
destroy - zerstören
develop - entwickeln
die - sterben
disappear - verschwinden
discover - entdecken
discuss - diskutieren
divide - aufteilen
do - tun
draw - zeichnen
drink - trinken
drive - fahren
drop - fallen lassen
eat - essen
enable - ermöglichen
encourage in - povzbudit v, ermutigen
enjoy - genießen
examine - untersuchen
exist - existieren
expect, await - erwarten
experience - erleben
explain - erklären
extend - erweitern
face - gegenüberstehen
fail - scheitern
feed - füttern
feel - fühlen
fight - kämpfen
fill - füllen
find - finden
fit - passen
fly - fliegen
follow - folgen
force - zwingen
forget - vergessen
forgive - verzeihen
found - gefunden
get - bekommen
give - geben
go - gehen
grow - wachsen
happen - passieren
hate - hassen
have - haben
hear - hören
help - helfen
hide - verstecken
hit - schlagen
hold - drzat
hope - hoffen
hurt - boliet
identify - identifizieren
imagine - predstavit si
improve - verbessern
increase - erhöhen
influence - beeinflussen
inform - informieren
introduce - vorstellen (niekoho)
invite - einladen
join - beitreten
jump - springen
keep - behalten
kick - treten
kill - töten
knock - klopfen
know - wissen
last - dauern
laugh - lachen
lay - legen
lead - führen
learn - lernen
leave - verlassen
lend, borrow - leihen
let - lassen
lie - lezat
link, connect - verbinden
listen - pocuvat
live - leben
look - schauen
love - lieben
make - machen
manage - verwalten
mark - markieren
mean - bedeuten
measure - messen
meet - treffen
mention - erwähnen
miss - verpassen
move - bewegen
need - brauchen
notice - vsimnut si
occur - vorkommen
open - öffnen
order - bestellen
own - besitzen
pass - vorbeigehen
pay - zahlen
pick, choose - wählen
place - platzieren
plan - plannen
play - spielen
point - punkten
prefer - bevorzugen
prepare - vorbereiten
press - drücken
prevent - verhindern
produce - produzieren
promise - versprechen
protect - schützen
prove - beweisen
publish - veröffentlichen
pull - ziehen
push - drücken
put - polozit
raise - erhöhen
reach - erreichen
read - lesen
realize - herausfinden
receive, get - erhalten
recognize - erkennen
record - aufnehmen
reduce - reduzieren
refer - verweisen
reflect - reflektieren
refuse, deny - zamietnut
remain - übrig bleiben
remember - zapamatovat
remove - entfernen
repeat - wiederholen
replace - ersetzen
reply - antworten
report - reportovat
represent - vertreten
require - vyzadovat
rest - ausruhen
result to - viesť k...
return - zurückkehren
reveal - odkryt
rise - stupat
roll - rollen
run - laufen
save - sparen
say - sagen
see - sehen
seem - zdat sa...
sell - verkaufen
send - senden
separate - oddelit
serve - sluzit
set - setzen
shake - schütteln
share - teieln
shoot - schießen
shout - schreien
show - zeigen
sing - singen
sit - sitzen
sleep - schlafen
smile - lächeln
sort - sortieren
sound - klingen
speak - sprechen
stand - stehen
start - starten
stay - bleiben
stick - kleben
stop - stoppen
study - studieren
succeed - Erfolg haben
suffer - leiden
suggest - vorschlagen
suit - niekomu pasovat
supply - zasobovat
support - unterstützen
suppose - annehmen
survive - überleben
take - nehmen
talk - sprechen
teach - lehren
tell - erzählen
test - testen
thank - danken
think - denken
throw - werfen
touch - berühren
train - trainiren
travel - reisen
treat - behandeln
try - versuchen
turn - abbiegen, umdrehen
understand - verstehen
use - verwenden
visit - besuchen
vote - abstimmen
wait - warten
walk - kracat, laufen
want - wollen
warn - warnen
wash - waschen
watch - beobachten
wear - nosit oblecene
win - gewinnen
wish - wünschen
wonder - neugirig sein, sich fragen
work - arbeiten
worry - sich Sorgen machen
would - würde
write - schreiben
have a very interesting discussion - mat zaujimavu diskusiu
have an argument - pohadat sa 
can we have a word - mozes na slovicko?
have a rest - oddychovat
have a break - dat si prestaku
have fun - zabavit sa
dont get me wrong - nechap ma zle
i havent made up my mind yet - este som si to nerozmyslel
save up time and money - usetrit cas a peniaze
divine - bozsky
dificullt to describe - tazko opisatelny 
frontyard, backyard - predzahradka, dvod
the other day, the other time - minule, nabuduce
cartooon - kresleny
maybe it ist just my feeling - mozno je to len moj pocit
she upset me, she got me angry - nastvala ma
obstacles - prekazky
follow - nasledovat 
observe - pozorovat 
you proved me wrong - presvedcil si ma
ever since i grown up i stopped doing that - odkedy som vyrastol, prestal som s tym
it cost a lot of money - stoji to vela penazi 
despite her age - navzdory jej veku
i admire her for such hard work - obdivujem ju kvoli tazkej praci
chamber - komora
sing up - zapisat sa
i am about to - prave idem nieco....
what does the package includes? - co ten balik zahrna?
he is as old as my son - je taka stara ako moj syn
she ist like me - ona je ako ja  
the stuff, i am most looking forward to - vec, na ktoru sa najviac tesim...
at such hight speed - v takej vysokej rychlosti 
i suppose - domnievam sa....
rate, rates - sadzby
staircase, stairs - schody
optionial, required - nepovinne, povinne
could you send some engineer, i guess my heating - mohli by ste poslat majstra, myslim ze moje kurenie  
as a mather of fact - v postate
i will give it a try - vyskusam to
let me get this straight - dovolte mi to vyjasnit
attitude - postoj
they are gone, sold! - su prec, predane!
what are you flying to madrid for - kvoli comu letis do madridu
well dressed - dobre obleceny
i am throwing party - organizujem party
puke, throw up - zvracat
what is it feel like to - aky je to pocit
thirsty - smadny
what is your honest opinion about - aky je tvoj uprimny nazor na..
why dont we try wine i won in the raffle - preco neskusime to vino co som vyhral v tombole ?
sorry i have kept you wating - sorry ze som ta nechal cakat
go bankcrupt - skrachovat
to overeat - prejest sa
bossy - panovacny
he skips breakfast - on preskoci ranajky
he is always late - vzdy meska
he loves tv - miluje telku 
in order to - aby
eye drops - ocne kvapky
exciting - napinave...
interpreting - tlmocenie 
side effects - bocne efekty
mislay - zapatrosit
beer lover - milovnik piva 
first of all, i want to - nazaciatok chcem...
its a really nice beer when it comes to - je to dobre pivo co sa tyka
take over - prebrat
draught beer - capovane pivo
it sucks - je to na hovno
its differrent, it tastes differently - je to ine, inak to chuti
in skandinavian countrys - v skandinavii
cheaper booze - lacnejsi chlast
consolidate - zgruput
rumour - klebeta 
its highly unlikely - vysoko nepravdepodobne
made up story - vymysleny pribeh
appealing - pritazlivy
i am not at home anyway - aj tak nie som doma
compare to - porovnavat s niecim
opportunity - moznost
beach - plaz 
something cut us off - nieco nas prerusilo
i've heard some rumours - pocul som nejake klebety
intention - zamer
whole, all, entire - cely ... 
recognise - rozpoznat 
remind (remind silent, be quiet) - pripomenut, zostat 
matter - mat vyznam, zalezat...
raise - zdvihnut s cuzdou pomocou
rise - stupa to samo
we wont have the morning lesson - nebudeme mat zajtrajsiu hodinu
do you have a car ? have you got a car ? - mas auto?
brand new - uplne novy
eider he lose it or he sold it - bud to predal alebo stratil
behave - spravat sa
conclusion - zaver, rozuzlenie
half naked - polonahy
in conclusion she ended up withou money - nakoniec skoncila bez jej penazi
back and forth - z jednej strany na druhu 
this long - takto dlhy 
mistakes - chyby
dirty, filthy - spinavy
clean up - poupratovat
square - stvorec
all squared - vsetko v poradku
how are you, how are you doing, whats neu, how ist everything, how is ist going, whats up - ako sa mas
what have you been up - co porabas
how do i get to - ako sa dostanem ...
do you kwon where - viete kde je ...
could you tell me the way to - mozte mi povedat cestu do ...
where is the nearest - kde je najblizsia...
go down this road and take the second left - chod dole touto ulicou a zaboc na druhej doprava
you have to go back - musite ist naspat
you have to cross the street - prejdite cez ulicu
what is the best (fastest) way to get to national museum - ako sa najlepsie dostanem do nacionalneho muse
at the corner of the building you will see a large dockyard - na rohu tej budovy budete vidiet velky pristav
you have to take the bus with number 15 and then get off at the second stop - musite zobrat 15ku bus a vystupit na druhej zastavke
hospital is opposite to shopping centre - nemocnica je naproti obchodneho centra 
after that, then - potom
next - nasledne
nie je to daleko - it is just around the corner
je to len 5 minut peso - its only 5 minute walk
its worth an affort - stoji to za to usilie
pay attention - davat pozor
menu - listok
drink menu - napojovy listok
wine card - vinna karta
bill, check - ucet
guest - host
customer - zakaznik
tip - sprepitne
service - servis
order - objednavka, objednavka
morning shift - ranna smena
cash register - pokladna
pay - platit
take (it will take longer than usually) - trvat
bowl - miska
plate - tanier
napkin - servitok
cutlery, silverware - pribor
spoon, fork, knife - lyzicka, vydlicka, nozik 
main course - hlavny chod
i want as rice as side - chcem rizu ako prilohu
french fries, fries, chips - hranolky
cleaning lady - upratovacka
rush hour - dopravna spicka
valuable (stoji vela penazi) rare (je ich malo) - vzacny
election - volby
reluctant to answer any question - neochotna odpovedat na otazky
significant, insignificant - podstatny nepodstatny
stickers - nalepky
washing powder - praci prasok
artifical - umely
so far - doposial 
until now - doteraz
back then - vtedy
jazzed up - nabudeny
as the day goes by - ako sa den rozbehne
fork out - vysolit
massive, huge fan - obrovsky fanusik
reminds me of - to mi pripomina
i cant remebmer eider - 
eider wein or champaigne - bud vino, alebo sampanske
draught beer - capovane pivo
major difference - velky rozdiel
during winter - cez zimu
nieder black nor red - ani cierny, ani cerveny
he is self-proclaimed economist - je samozvany ekonom
duration of - trvanie
tender - jemny
what does it taste like ? - ako to chuti ?
plain - obycajny
former colleagues - byvaly kolegovia
yes and no - ano aj nie
its eatable - je to jedle
they ask me whether - pytaju sa ci...
the services are overpriced - sluzby su predrazene
appear (she seems to me, she appears to me) - objavit sa, okazovat sa ako...
splendid - vyborny
i havent made up my mind yet - este som si to nerozmyslel
i am still hazy - este stale som nerozhodny
bad purchase - zla kupa
it would be very binding - bolo by to velmi zavazne
land - pozemok 
i want to teach less - chcem ucit menej
ask for raise - poziadat o zvysenie
i value my time - cenim si svoj cas
couple - par ludi
a pair - par, nie ludia
carry - nosit
torn, torn up - roztrhnuta
turn up the volume - dat nahlas
to max it up - na plne gule
optically is canon second to none - opticky nema canon obdoby
what do you have lined up, whats the plan for today - jaky mas dneska plan
it gives me plenty of time to have breakfast to have more relaxing morning - dava mi to cas aby som mal relaxovane rano
simple, straightforward - jednoduchy
you are best at it - si v tom najlepsi
i was just joking - len som srandoval
brewery, breweries - pivovar
it seems like main-streem event - vyzera to ako masovka
all tents were crowded - vsetky stany boli plne ludi
traditional - tradicne
unknown, less known - neznamy, menej znamy
pasovat - smuggle 
obchod s bielym masom - prostitution
rukojemnik - hostage 
blend in - vmiesat sa 
kukurica - korn
subsidiary, branch - pobocka
miss on - premeskat 
nornern, southern, western, eastern part - severna, juzna, zapadna, vychodna cast 
spectator - divak
audience - publikum
nou camp can seat 99 000 - nou camp moze posadit 99 tisic ludi
i am getting hungry - zacinam byt hladny
i have never been to barcelona either - ani ja som nebol nikdy v barcelone
i dont like seafood - nemam rad morske plody 
me neither, me too - ani ja, ja tiez
from now on - od teraz
equally - rovnako
in addition - este k tomu
it has its ups and downs, pros and cons, positoves and negatives, pluses and minuses - ma to stvoje plusy a minusy
this is mainly because - toto je hlavne preto...
it got on to me - dolahlo to na mna
i always hated - vzdy som nenavidel
until 8.30 in the evenging - do 8.30 vecer
precios 30 minutes -  vzacnych 30 minut
catch up - dobehnut 
it makes sence - dava to zmysel
paycheck - vyplatna paska
damn - do pekla
partially - ciastocne 
realize - vsimnut si 
take drugs - brat drogy
waste time - marnit cas..
spread - rozsirovat, natriet...
eat out - jest vonku 
foresee - predvidat 
year and a half - rok a pol
we have been marrired for 18 months so far - sme zobraty 18 mesiacov
considerate - ohladuplny
skip - vynechat 
it not approriate to invite your girfriend - nie je vhodne aby si pozval priatelku
i am sorry about that - je mi to luto
i could have been better - mohlo to byt lepsie
i havent even asked - ani som sa nepytal
scuba-diving - potapanie
i wish you the very same to you - podobne (zelam ti to iste)
its very good deal, pretty good bargain - je to vyhodna kupa
i was impressed / amazed - bol som z toho na vetvy
take off - vzlet 
emergency landing - nudzove pristatie 
fortunately, luckily - nastastie
round trip ticket, return ticket - spiatocny listok
type - pisat na pocitaci
fill in, fill out - vyplnit
yeah, he is in the office, hold on for a second i will put you trough - ano, je v office, pockajte, prepojim
you cannot even imagine what he put me trought - nevies si ani predstavit cim som si kvoli nemu presla
het put me trough lot of trouble, lot of pain - presliel som si kvoli nemu vela starostami 
repair, fix, do up - opravit 
we will have to do it up - porobit, prerobit
leackage - netesnost
majority of the stuff  - vacsina tych veci
sufficient - dostatocne
in order not to get suspicious - aby sme sa nestali podozrivy
initial - pociatocny
altitude - vyska (nadmorksa)
of this scale - tychto rozmerov
chimney - komin
it costs 3000 EURO for the fireplace itselft - stoji to 3 tisic len cisto za ten krb
it has got its pros and cons - ma to klady a zapory
it was ridiculous - to bolo nasmiech
this is not the case - toto nie je ten pripad
to rely on - spolahnut sa na 
get stuck - zaseknut sa 
get sidetrack - rozptylovat sa
lifestyle - zivotny styl
trifles - malickosti
overflow - preplnit, zahltit
ist bloody ugly - je to kurva spatne
prevent - zabranit
avoid - vyhnut 
replace - nahradit
separate - oddelit
compete - sutazit
verify - overit
commit - spachat 
wipe - utierat
betray - zradit
reveal - odhalit
bribe, take bribes - podplacat, nechat sa podplatit
change - zmenit
perform - predvadzat
prove - dokazat dokazom 
refuse, reject - odmietnut
deny - zapierat
critisize - kritizovat
settle down - settle down
supply - dodavat
warn - varovat
flip over - prevratit 
attract - pritahovat
bully - sikanovat
charge, recharge - nabijat
act funny - blbnut 
instantly - okamzite 
number plates - spztky
how they deal with you - ako s tebou zaobchadzaju
it has it roots in history - ma to korene v minulosti
he did it on purpose - urobil to naschval / zamerne
plus - plus
how it will all work out - ako to vsetko dopadne
snow is gone - sheh je prec
the quality is second to none - kvalita je tip top
i discounted 5d mark ii, because of - zamietol som 5d, pretoze
even though - aj ked 
dont gudge book by its cover - nesud knihu podla obalu
decent quality - slusna, priatelna kvalita
at the time when i was choosing my camera  - vtedy ked som si vyberal kameru
he is very amusing - je zabavny
prioritise - priorizovat
annualy - raz rocne
sure thing, sure, of course, absolutelly - jasne !
novell - roman
send through, by, via email - poslat mailom
what have you just said - co si prave povedal
say - nieco povedat
tell - niekomu nieco povedat
forbidden, banned - zakazane
i should have listened to you - mala som ta pocuvnut
reading glasses, sun glasses - okuliare
research, survey - priezkum
get ahead - predbehnut, dostat sa pred niekoho
get up - vstat
get across - prejst cez cestu, gest some ideas across
get by - vyzit, its difficult to get by with 300 eur if you are single
get close - priblizit sa 
get through - dostat sa cez nieco, nemohol som sa ti dovolat a couldnt get trough
get away - zmizni, uniknut, zmiznut, bank robber got away, prepiect - i always get away
get together - stretavat sa 
get behind - byt pozadu. i am getting behing my schedule
get back - vratit sa spat
get on - get along - how do you get along with your wife
get up to - mat nieco nekale za lubom
at the moment - momentalne
meat after expiration period - maso po zaruke
go at full throttle, half throttle - ist na plny/polovicny vykon
go over, cross, pass - prejst
atm machine, cash machine - bankomat
withdraw money, money withrawal - vytiahnut peniaze
luggage - batozina
holy mass - svata omsa
dont make any excuses, make excuses... - nevyhovaraj sa
to be on the bring - na pokraji
to be on the enge - byt na okraji
start off - zacat, rozficat, rozbehnut
based upon - na zaklade
hang around in the city center - flakat sa v centre
to game, to gamble - gemblit
draft - navrh 
i am involved to couple of thing that are related to this purchase - som zainteresovany v par veciach ktore suvisia s tymto predajom
extend - rozsirit, zvacsit
defeat - porazit
kick ass - fertig machen  
succeed - uspiet
she has been claiming that for the past 2 years - tvrdi to posledne 2 roky
its still on my radar - mam to stale na radare
i dont feel like working today - dnes nemam chut pracovat 
despite the fact - napriek skutocnosti
upcoming weekend - nastavajuci vikend
quite - celkom
quiet - tichy
doctor, GP - doktor
and that brings me to question - a to ma privadza k otazke
backyard - zahrada
tank - nadrz
cattle - dobytok
as a matter of fact - v podstate
stinky rich - nechtutne bohaty
afford (even milionairs cant afford this, i cant afford this) - dovolit si 
confirmation - potvrdenie
on the other hand - na druhej stranex     
one handfull, one spoonfull - za hrst, za lyzicu
convenient - vhodny
in the end - nakoniec
on time, precise - presny
however - avsak
i saw some headlines - videl som titulky
i dont follow it in depth - nesledoval som to do hlbky
i am involved in flat renovation - som momentalne zapojeny do renovacie bytu
you can run into serious problem - mozes sa dostat do problemov
find out - zistit
look for - hladat
look up - vyhladat
look over - prehladat
look round - rozhliadnut sa
look into - vysetrovat
take after (he takes after his father) - podobat sa
grow up - vyrast
look after - starat sa
bring up - vychovat 
do up, zip - zapnut, kabat zapnut
look back - pozerat sa naspat, spominat si
put trough - prepojit co sa tyka telefonovania, sposobit nieco niekomu
speak up ((speak up now, otherwise you wont get another chance, can you speak up a bit) - hovorit hlasnejsie, povedat svoj nazor teraz 
cut off (something cut us off) - odstrihnut, nieco nas prerusilo 
hold on - vyckaj, pockaj
get trough (i coudlnt get trough) - prejst si cez nieco, dovolat sa - nemohol som sa ti dovolat
break down - pokazit sa, your voice is breaking down - nepocjem ta
break up - rozist sa, rozbit sa na kusky, rozdelit 
break off - odmlcat sa, ukoncit vztah
make up - vymyslat si, she just made it up, udobrit
make up for - dohonit co ti uniklo, i wanted to make up for all the lost time 
fall out - vypadnut
we spend the whole day biking - cely den sme bikovali 
i want to give it a shot, i want to give it a try - chcem to skusit\
grate - nastruhat 
equals - zodpoveda
spotless - bez spinky
mountin cabin - horska chata
tranquile, quiet - kludny 
spoil - rozmaznavat
i feel like - mam na nieco chut
put me on copy - daj ma do cc
disappear into thin air - vyparit sa
basically - v podstate
start from the scatch - zacat od piky
to have a chat - pokecat
i didnt work out - nefungovalo to
i would better - radsej by som
comuters, comute - pravidelne chodit do prace
slippery, icy - klzke, zladovatele
wine cellars under his house and around his house - vinne pivnice pod jeho domom a okolo jeho domu
rack - stojan
alternate - striedat
several - niekolko  
hall - chodba
its not profitable anymore  - nie je to uz rentabilne
whe shall see - uvidime 
curious, wonder - zvedavy kratkodobo a dlhodobo
in regards to english - co sa tyka anglictiny...
you need to advertise, some sort of advertisement, advert, ad - potrebujes reklamovat (davat reklamu), reklama
hooking up - dat sa dokopy...
helpful - napomocny
usefull - uzitocny 
persuade - presvedcit 
larger impact - vacsi dosah
certain direction - urcitym smerom...
long therm plan, short therm plan  - kratkodoby a dlhodoby plan 
i travel to slovakia - cestujem na slovensko za 2 mesiace
appareantly - udajne
pushy - dotieravy
street vendor - poulicny predajca
i was under impression - mat dojem, mal som dojem
na ulici - in the street
on the beach, by the sea - na plazi, pri jazere
boom- rozvijat sa, rozvoj
gadget fleet - letka zariadeni
drawback - nevyhoda
nothing to write home about - nic moc
to work you way around it - nejak na to prist
pinpoint - vypichnut 
educate - vyucovat
in real life - v paxi 
i am desiding on what to buy - rozhodujem sa o tom co kupim
rozptylovat sa - get sidetracked
pohostinny - hospitable, inhospitable
mat dojem - have impression
make impression - spravit dojem
make a strir - urobit rozruch
overtake - predbiehat
fluke  - to bola haluz 
perception - vnimanie 
perceive - vnimat
remarkable - mimoriadny  
average, mediocre - priemerny
cheapo - lacak
wierdo - cudak
you are out of luck - mas smolu
i cannot afford - nemozem si dovololit
skin is burned - pokozka je spalena
it took its toll - zobralo si to svoje meto
much langer than slnava - ovela dlhsie ako slnava
ruined - zniceny
set up a fire - zalozit ohen
fireplace - ohnisko 
very close to - velmi blizko k
lets call it a day - ukoncit nieco
slovak girl, slovakian girls - slovenske baby
it is not so spred out - nie je to tak rozsirene 
put them up - i will upload them - uploadnem ich
i even took a video of the bidet - dokonca som nahral video bidetu
concerning (i want to show you one picture concerning asparagus) - ohladom
splash - rozliat, vysolit za nieco
L stands for luxurius - L znamena luxusny
he was bragging about it - chvastal sa tym
unfair - nespravodlivy
justice, injustice - spravodlivost, nespravodlivost
it appears unfair to me - vidi sa mi to nepsravodlive
downloading movies off the internet - stahovanie filmov z internetu
when it comes to - co sa tyka....
afterward - potom 
as long as - tak dlho ako 
as soon as - akonahle 
after a while - po chvilke
until - do (ak neurcujeme pociatok) 
presently - prave teraz 
shortly - coskoro, zanedlho 
simultaneously - subezne 
until now - doteraz 
at last - nakoniec 
at that time - v tom case 
so far - doposial 
subsequently - nasledne 
when - ked 
appear - objavit sa
the boss of my wife - sef mojej zeny
save every little penny, cent - usetrit kazdy cent
i am all ears - som cele ucho
so it wont be so dramatic - nebude to take dramaticke
modify - modifikovat
if depends on what you looking for - zalezi co hladas
swirl of events - vir udalosti
compfortable - pohodlne
pleasant, enjoyable - prijemne
you could smell it in the whole plane - mohol si to citit v celom lietadle
at around 7 PM (nie o nineteen o clock - to je ciste military) - okolo siedmej poobede 
time change - casovy posun
ring someone trough - niekoho prezvonit
capable - schopny (negativne)
to outsmart someone - prelstit niekoho (vypiect s niekym)
slag off - ohovarat
gossip - klebetit
vydierat - blackmail 
force someone to do something - nutit do niecoho
talk someone into something - nahovorit do niecoho
putting a preasure on somebody - tlacit na niekoho
lie (he lied to me) - klamat
cheat - podvadzat
missuse - zneuzit
i would do it for you - urobila by som to pre teba
groceries shop - potraviny
we used to talk to each other, but its a long time ago - Kedysi sme sa rozpravali ale je to uz davno
we used to book tickets only trough him - Kedysi sme si objednavali listky iba u neho
sufficient - dostacujuci
rich - bohaty
admire - obdivovat 
topic - tema
theme - tematika
resume - obnovit
nice of you - mile od teba
continue, carry on - pokracovat
slack off, slacker - flakat sa, flakac
quote - vyrok
fruitfull - plodny
start up - startovat
really ? - naozaj ?
at my place - u mna
hat - capica
chef - sef
productive - produktivny
reliable - spolahlivy
firm - prisny
firm, company - firma
encoraging - povzbudivy
selective, fussy, picky - vyberacny
all the time - cely cas 
have excuses - mat vyhovoryky
i have been 5 times to greece - bol som 5x v grecku
unless - jedine ze by
time change - zmena casu
not my cup of tea - nicht mein ding
crucial, essential - podstatny
submit - odoslat
premission - poovlenie
ist not valid - nie je platny
landmark - pamatihodnost
picturesque - malebne
at the border - na hranici
i would like to get to know you - rad by som ta spoznal
chill out by the see - lenosit pri jazere 
we dont get along - nevychadzame dobre
the next milestone is gonna be wedding - dalsi mylnik bude svadba
sincere - uprimny
dilligent - svedomity
curious - zvedavy
sociable - spolocensky
easy going, cool, laid back - v pohode
talkative, chatty -  zhovorcivy
chubby - pribraty
scruffy - otrhany
hansome - fesny
cunning - vychcany
big headed, full of himself- namysleny
lakomy - cheap
impatient, patient - trpezlivy, netrpezlivy
introverted, extroverted - introvertny, extrovertny
wierd - cudny
freak - uchyl
sausage - klobasa
i shoundnt have eaten it - nemal som to jest
acomplish - dosiahnut, uskutocnit
i beg your pardon - prosim o prepacenie
not at all - vobec nie  
you are welcome - nemas zaco
the problem i am currently struggeling with is that - problem s ktorym sa trapim je...
certain - urcity 
recipe - recept 
exhausted - vycerpany
i need to return to - musim sa vratit k...
too little - prilis malo  
despite - napriek
whereas - pricom, zakial co ...
get tired - unavit sa  
vicinity - okolie
tiring  - unavujuci 
sophisticated - premysleny
apperantly - ocividne
they offer only what is in demand - ponukaju len to na co je poptavka
appropriate - vhodne
you put it somewhere aside - odlozs to niekam na stranu
sleepy, drowsy - ospaly 
would you like - chcel by si
i have doubts - mam pochybnosti 
have no doubts about it - o tom nepochybuj
load, unload - nalozit vylozit 
could you help me to - mohol by si mi pomoct
phone him, i will ring him, i call him, i give him a call - zavolam mu 
whenever you wake up - kedykolvet sa zobudis
whatsoever - was auch immer
you can do whatever you want - mozes robit co len chces
ok, whatever - hovor si co chces
my mobile is dead - mam vybity mobil
my battery is dead - mam vybitu materku
we are already leate - uz meskame
naughty - neposlusny
some kinds are good , some are naughty - niektore deti su poslusne, niektore neposlusne
audio tape - audio paska
are you crazy ? are you nuts ? - sibe ti ? 
what do you like reading the most ? - co najradsej citas ?
crime - zlocin
you should leave it here - mal by si to tu nechat, rada
you suppose to leave it here - ocakavam, ze to tu nechas, niekto to ocakava
you have to leave it here - musis to tu nechat
we cant, we cannot - nemozme, jasne naznacene
counterpart - ansprechpartner
the sights - pamiatky 
on the way - na ceste 
i have it at the back of my mind - nieco mat v hinterkopf
i want to finish it off - dokoncit, ukoncit
where does it take place - kde sa to kona
it will be held at hilton hotel - kona sa to v hilton hoteli
where are you - kde si
envy - zavidiet
in restaurant - v restauracii
in the shop - v obchode
in the toilets - na toaletach
at the bank - v banke
at the hotel, in the hotel - v hoteli 
i donno its name - neviem ako sa to vola
exploiting - vyuzivat...
he is well-rounded - rozhladeny
be educated - vzdelany 
in terms - vzhladom na 
apperently - zjavne
responsibly - zodpovedne 
leave - odist 
quit - odist v strede nejakeho procesu 
bite - susto 
seize - schmatnut, uchopit, chytit sa pilezitosti
hand, arm, shoulder - ruka, rameno, plece 
get along - vychadzat si
rely on - spoliehat sa na 
supoprt - podporovat
donate - darovat 
discuss things - diskuptovat o veciach 
go over things - prejst si cez veci 
take a exam - mat skusku
those times are over - tie casy su prec
5 years and six month - 5 rokov a 6 mesiacov 
lecture - prednaska
procrastrinate - odsuvat, prokrastinovat
classmates, schollmates - spoluziaci  
warehouse - sklad 
an interview - pohovor
literally - doslovne 
plought trought a book - prebrodil som sa knihou 
further details - dalsie detaily
additional information in-depth - dodatocne informacie detailne
knowledge - znalost
ever since, since then (And I have been working with Java ever since/since then) - odvtedy 
hold on to this job - drzat sa pevne niecoho
move forward - posuvat sa dopredu
this ist my 7th company that i have worked for - toto je 7ma spolocnost pre ktoru som pracoval
newcomer (to codewriting) - zaciatocnik
any - lubovolny
relatively - relativne 
swear, promise - prisahat, slubit
swear, curse (stop cursing) - nadavat
gain weight -pribrat
Always, regularly, normally, usually, often, sometimes, occasionally, rarely, seldom, never - vzdy, pravidelne, normalne, zvycajne, casto, niekedy, prilezitostne, zriedkakedy, malokedy, nikdy
yesterday - vcera
last week - minuly tyzden
last weekend - minuly vikend
last month - minuly mesiac
last summer - minule leto
in summer - v lete
on Friday - v piatok
in 1987 - v 1987
in May - v Maji
3 days ago - pred tromi dnami
one year ago - pred rokom
when I was young - ked som bola mlada
when I was small - ked som bola mala
last night - minulu noc
2 hours ago - pred dvomi hodinamy
yesterday evening - vcera vecer
in the morning - rano
after school - po skole
after work - po robote
when we lived in Piestany - ked sme byvali v Piestanoch
when I lived in Austria - ked som bola v Rakusku
when I was at high school - ked som bola na strednej skole
before the war - pred vojnou
before the revolution - pred revoluciou
from 1992 to 1998 - od 1992 do 1998
when we moved to France - ked sme sa prestahovali do Francuzska
in the past - v minulosti
on Sunday afternoon - v nedelu poobede
on Saturday morning - v sobotu doobeda (rano, doobeda, dopoludnia)
on Friday evening - v piatok vecer
at that time - v tom case
back then - vtedy
in 17th century - v 17 storoci
adventure - dobrodruzstvo
unique - unikatny
get engaged - zasnubit sa
i proposed her - navrhol som jej
you would not stand a chance, have a chance - nemal by si sancu
sleding - sankovanie
awake - zobudeny
rare, medium, well done - prepeceny, stredne, trochen
salad - salat
pancakes - palacinky
roasted chicken - pecene kura 
roasted duck - pecena kacica 
salmon - losos
cheese foundue - syrove fondue
purchase, shot - nakupovat formalne / nakupovat
see a docktor, visit a doctor - navstivit doktora
sick, ill - chory
have a break, have rest ... have pause... - mat prestavku
appreciate - vazit si, cenit si 
reminder - pripomienka
remind - pripomenut 
collect - zbierat do zbierky
pick up - pozbierat 
have a chat - pokecat ...
continue - carry on - pokracovat
she keeps calling me all the time - stala aktivita, stale mi vola, cely cas 
keep - neprestavaj 
redo, remake - prerobit
adjust - prisposobit
correct - opravit (slovnu chybu)
fix, repair, mend - opravit 
advise, advice - poradit, rada
since - pretoze (na zaciatku vety)
she is getting ready for work - pripravuje sa do prace
the beginnings are tought - zaciatky su tazke
endurance - vydrz 
in most cases - vo vacsine pripadov
this ist not the case - toto nie je ten pripad
for the time been - zatial
i discussed this matter with lenka - hovoril som o tejto zalezitosti s lenkou
most of the girls need attention - vacsina zien potrebuje pozornost
therefore - preto
i've moved out - vystahoval som sa
i follow this advice - riadim sa touto radou
vote - volit
at the top of the page - na vrchu stranky
i got lucky - postastilo sa mi 
turn on, off the water - zapnut, vypnut vodu
can - nadoba  
rare kind - ojedinely druh
my health state is getting worst - moj zdravotny stav sa zhorsuje
liquid - tekutina
painfull - bolestivy
disease - choroba
spine - chrbtica 
vaguely - matne 
substance - latka 
currable , incurrable - liecitelny, nevyliecitelny
i allways wonder - vzdy sa cudujem, zaujimam sa 
i havent come across such a feature - nenarazil som na taku ficuru 
garage - garaz
struggle with - zapasit s 
lets switch to more positiv topic - prepnime na pozitivnejsiu temu
leave for - vydat sa niekam
are you still learning german - stale sa ucis nemcinu ?
at school - v skole
case by case, on ad hoc basis - od pripadu k pripadu
on daily basis - denne
on regular basis - pravidelne
motherhood duties - materske povinnosti 
withdraw - stiahnut sa spat, vytiahnut peniaze
80 EUR per hour - 80 za hodinu
what regards the other option - co sa tyka tej druhej moznosti
you dont need any power - nepotrebujes ziadny prud
without having to turn off all application - bez nutnosti vypinania aplikacii
therefore i usually decide to put the computer to sleep mode - zvycajne sa rozhodnem dat pc do sleep modu
there is no significant difference - nie je tam podstatny rozdiel
any further consequences - ziadne dalsie konsekvencie
famous, popular, well known - znamy
i had high expectations before the event - pred tou udalostou som mal velke ocakavania
there were - boli tam
name -  pomenovat   
bring up / brougt up / raise / be raised - vychovat
dit you win or did you lose ? - vyhral si alebo prehral ?
nothing comes to my mind at the moment - momentalne mi nic nenapada
signature - podpis
sign - podpisat
bring, get you - priniest
we try to raise the standard - zvysit standard
estimate - odhadnut
sale - predaj, predat 
rude - drzy
polite - slusny
inpolite - neslusny
vary (the prices may vary) - kolisat
fund - zafinancovat
fund raser - zbrierka penazi
convince, convincing - presvedciva 
participate ( i had to participate on meetings in our company) - zucastnit sa
separe - oddelit
fortunatelly - nastastie 
by accident, by chance - nahodou
on your own, on my own - sam
directly - priamo
bad, worse, the worst - zly, horsi, najhorsi
what ist the drawback - aka je nevyhoda
suitable backup - primerana zaloha 
i would opt for it - rozhodol by som sa pre to
i spotted - zbadal som
discipline - disciplina
among thouse - medzi tymi...
area - oblast 
brackets - zatvorky 
inner life - vnutorny zivot
subconsiensousnes - povdvedomie
we never do that - nikdy to nerobime
emotions have strong influence - emocie maju silny vplyv
persuade - predvecit
in other words, more precicely, if you like - respektive
on the contrarty - na druhu stranu, naopak
prior (i woke up 10 minute prior lesson) - pred, zobudil som sa 10 min pred hodinou 
once you get some time - ked budes mat cas
come along, stop by - zastavit sa
sacrify - obetovat
pain in the ass - bolest v zadku (ked nieco nervuje) 
i noticed this sort of pain - vsimol som si tento druh bolesti
take up (i took up playing golf....) - zacat s nejakou aktivitou, zacal som s golfom
i lost 18 kilograms during that period - stratil som 18 kilo v tej dobe
disolve - roztopit 
additcted to coffee - zavisli na kave
revitalizate - revitalizujuci 
juice - dzus
it makes you put on weight - ztlstnes z toho 
different types of fruit - rozne druhy ovocia
be aware of - byt si vedomy
tap - tocka
tap water - voda z tocky
still water - ticha voda
sparkling water, fizzy water - perliva 
flavoured drinks, soda drinks - ochutene napoje - seven up, fanta, cola 
drinking water - pitna voda
bottled water - flaskova voda
drinking fountain - picia fontana
hart - tvrdy 
soft - makky 
be right, i am right - mat pravdu
i would like to get advice from you about the further progress of this complex business solution - chcel by som od teba radu o dalsom progrese tohto business riesenia
hardworking - pracovity
diligigent - svedomity
creative - vynaliezavy 
objections - namietky
suggestions - navrhy
it will take place in bratislava - bude sa to konat v bratislave
rough estimate - hruby odhad
she didnt convince me - nepresvedcila ma
expenditures - vydavky
overcast - zamracene
tear apart - roztrhat, rozobrat
heavy rain - silny dazd